NO textures/north.xpm
SO textures/south.xpm
WE textures/walls.xpm
EA textures/walls.xpm

F 60,30,10
C 0,0,0

1111111111111111111111111
1000000000000000000000001
1011000000000000000000001
10010000000000000E100000111111111
111111111011000000000000000000001
1000000000110000000001111111111111
11110111110000000000010001
11110111111111011101010010001
11000000110101011111000010001
1000000000000000100100000010001
10000000000000001111000010001
10000000000000001100000010001
10000000000000001101010010001
1100000111010101111101111000111
11111111111111111111111111111