NO textures/north.xpm
SO textures/south.xpm
WE textures/west.xpm
EA textures/east.xpm

F 60,30,10
C 0,0,0

1111111111111111111111111
1000000000000000000000001
1011000000000000000000001
100100000000000000100000111111111
111111111011000000010000000000001
100000000011000000000S11111111111
11110111110000000000000001111
11110111111111011101000010001
1100000011010101111100001000111
1000000000000000100100000000001
1100000000000000111100001000111
10000000000000001100000010001
10000000000000001101000000001
1100000111010101111100000000111
11111111111111111111111111111