NO textures/walls.xpm
SO textures/walls.xpm
WE textures/walls.xpm
EA textures/walls.xpm

F 60,30,10
C 173,216,230

1111111111111111111111111
1000000000000000000000001
1011000000000000000000001
10010000000000000E000000111111111
111111111011000000000000000000001
1000000000110000000001111111111111
1111011111000000000001000111
11110111111111011101010010001
110000001101010111110000100011
1000000000000000100100000010001
100000000000000011110000100011
10000000000000001100000010001
10000000000000001101010010001
1100000111010101111101111000111
11111111111111111111111111111