NO textures/walls.xpm
SO textures/walls.xpm
WE textures/walls.xpm
EA textures/walls.xpm

F 60,30,10
C 173,216,230

11111111111111111111111111      
11000000000000000E00000001
10000000000000000000000001
11111111111111111111111111111