111111111111111
100100000000101
100100011101001
100000000000001
100000000001111
10000E0000000011111111111111111111111111111
111000000011000000000000000000000000000001
1000010001000000000000000000000000000000001
1000010000000011111111111111111111111111111
111111111111111