   NO		textures/f1.xpm
SO textures/f2.xpm
WE      textures/f3.xpm
EA textures/f4.xpm
C 0,   0 ,0
F   50,   50,50
11111
100E01
11111

