NO textures/metal.xpm
SO textures/metal.xpm
WE textures/metal.xpm
EA textures/metal.xpm

F 64,64,64
C 135,206,235
  

11111111111111111
10000000N00000001
10110000000000001
10000000000000001
10110000000000001
10000000000000001
10110000000000001
10000000000000001
10110000000000001
11111111111111111
   
