NO textures/metal_grid.xpm
SO textures/metal_grid.xpm
WE textures/metal.xpm
EA textures/metal.xpm

F 64,64,64
C 135,206,235

1111111111111111111111111
        1000000000110000000000001
        10110000011100000S0010001
        100100000000000000000000111111111
111111111011000001110000000000001
100000000011000001110111111111111
11110111111111011100000010001
11110111111111011101010010001
11000000110101011100000010001
10000000000000001100000010001
10000000000000001100000010001
10000000000000001100000010001
10000000000000001101010010001
1100000111010101111101111000111
11111111111111111111111111111
